7  8  4  15 23 16 5  3  19 2  6  64 64 64 64 64 64 64 64 64 64 64 22 1  29 30 24 10 11 26 27 19 28
24 27 5  14 13 30 8  29 18 6  22 64 64 64 64 64 64 64 64 64 64 64 31 12 25 21 16 2  19 3  0  5  18
9  5  30 19 7  25 2  18 20 17 8  65 64 64 64 64 64 64 64 64 64 65 1  12 23 14 21 24 3  13 0  27 2
26 19 23 16 5  14 10 31 28 9  22 17 64 64 64 64 64 64 64 64 64 11 15 21 8  29 20 4  13 24 2  12 13
20 27 2  9  31 10 0  6  21 14 25 17 65 64 64 65 65 65 64 64 65 3  18 11 30 29 8  4  16 19 1  7  22
6  24 30 19 8  17 1  31 5  22 23 25 12 65 65 60 48 61 65 65 29 27 28 4  14 20 18 11 16 10 3  13 17
10 29 1  23 26 8  7  0  28 19 31 17 21 2  57 57 41 48 56 3  14 11 12 4  22 16 27 15 30 24 25 10 26
1  3  17 28 6  27 2  0  13 11 25 9  19 16 12 48 57 56 20 5  29 4  15 21 23 14 7  24 22 10 31 18 31
14 30 26 13 21 12 11 31 8  10 7  24 18 6  27 41 48 55 2  5  29 1  4  19 28 17 20 3  25 23 16 6  1
27 14 3  11 13 2  21 25 6  7  0  9  16 19 28 47 48 57 10 12 5  23 20 18 31 22 24 30 8  29 1  2  9
27 12 19 0  16 9  10 21 28 18 17 13 24 20 55 48 41 48 17 8  26 12 4  31 10 19 3  24 13 9  6  20 28
6  22 23 11 2  14 7  25 30 8  31 12 20 18 53 56 48 47 1  15 30 7  22 18 26 29 23 11 5  25 2  8  14
13 26 7  10 28 9  22 4  16 19 25 1  31 18 5  55 48 48 19 17 9  23 2  31 5  15 12 18 10 22 7  26 0
21 23 14 27 2  30 0  17 12 8  16 3  19 31 25 48 41 48 25 6  16 27 20 1  14 11 30 28 8  24 13 29 21
28 5  9  16 19 30 23 6  25 2  10 0  12 27 31 47 57 48 54 17 5  24 18 12 9  2  13 7  31 19 25 30 8
31 24 18 11 27 4  21 6  10 15 3  17 25 9  29 48 48 55 52 27 16 1  23 29 28 14 9  18 3  12 24 20 21
2  21 26 6  0  9  8  27 13 17 23 28 22 1  18 48 48 47 3  10 4  29 31 5  7  11 14 12 20 30 24 15 29
9  5  18 1  31 3  13 7  10 8  0  6  26 29 28 18 48 56 25 11 16 22 19 4  30 21 17 27 15 24 2  23 25
7  4  29 19 18 2  11 16 28 27 21 0  10 30 9  6  1  31 8  12 23 22 5  24 14 25 20 3  13 17 26 8  24
0  18 3  4  14 23 19 25 1  9  8  12 13 6  30 11 5  7  28 29 20 10 26 21 22 31 17 27 16 15 2  17 29
19 22 12 7  9  6  14 27 28 31 18 2  5  15 21 4  16 11 3  17 30 13 24 23 10 8  29 26 20 1  25 9  30
10 0  7  28 5  3  30 21 18 27 31 13 17 8  19 12 29 14 26 25 2  9  4  23 22 11 24 16 15 6  1  4  14
26 11 3  2  21 1  27 16 31 12 30 4  9  7  8  19 24 13 6  18 17 25 15 29 23 22 28 20 5  10 14 4  6
9  24 20 19 14 4  6  1  3  10 7  29 13 23 25 11 28 16 18 31 12 21 8  2  15 17 30 22 27 5  26 28 27
17 26 12 13 14 20 9  30 28 15 7  6  23 2  3  31 11 8  24 22 5  25 18 29 21 16 4  10 27 1  19 25 30
10 28 13 31 6  19 23 11 4  27 2  7  8  1  17 29 18 12 14 25 30 21 16 9  20 15 22 3  26 24 5  21 22
10 28 13 31 6  19 23 11 4  27 2  7  8  1  17 29 18 12 14 25 30 21 16 9  20 15 22 3  26 24 5  13 17
14 3  20 19 11 2  25 17 30 7  31 10 6  9  28 4  23 18 13 12 8  16 29 21 22 24 27 5  26 1  0  12 14
5  10 21 8  1  24 30 29 28 26 3  14 17 18 25 31 9  15 11 2  22 7  23 4  13 12 20 16 6  27 0  1  27
