-6 0 1 3
-6 1 1 1
-5 0 1 1
-5 1 1 1
-4 0 1 1
-4 1 1 1
-3 0 1 1
-3 1 1 1
-2 0 1 1
-2 1 1 1
-1 0 1 1
-1 1 1 1
0 0 1 1
0 1 1 1
1 0 1 1
1 1 1 1
2 0 1 1
2 1 1 1
3 0 1 1
3 1 1 1
4 0 1 1
4 1 1 1
4 2 2 2
4 3 2 2
4 4 2 2
4 5 2 2
5 0 1 1
5 1 1 1
5 2 2 2
6 0 1 1
6 1 1 1
6 2 2 2
7 0 1 1
7 1 1 1
7 2 2 2
8 0 1 1
8 1 2 2
8 2 2 2
9 0 1 1
9 1 2 2
9 2 2 2
10 0 1 1
10 1 2 2
10 2 2 2
11 0 1 1
11 1 2 2
11 2 2 2
12 0 1 1
12 1 2 2
12 2 2 2
13 0 1 1
13 1 2 2
14 0 1 1
14 1 2 2
15 0 1 1
15 1 2 2
16 0 1 1
16 1 2 2
17 0 1 1
17 1 2 2
18 0 1 1
18 1 2 2
18 2 2 2
18 3 2 2
18 4 2 2
18 5 2 2
19 0 1 1
19 1 2 2
20 0 1 1
20 1 2 2
21 0 1 1
21 1 2 2
22 0 1 1
22 1 2 2
23 0 1 1
23 1 2 2
24 0 1 1
