4 11 2
4 12 2
4 13 2
4 14 2
5 11 2
5 14 2
6 6 2
6 7 2
6 8 2
6 11 2
6 14 2
6 15 2
7 5 2
7 6 2
7 8 2
7 9 2
7 10 1
7 11 1
7 15 2
8 5 2
8 9 1
8 10 1
8 11 1
8 12 1
8 15 2
9 5 2
9 12 1
9 15 2
10 11 1
10 12 1
10 14 2
10 15 2
11 6 1
11 7 1
11 8 1
11 11 1
11 14 2
12 8 1
12 9 1
12 10 1
12 11 1
13 9 1
13 10 1
13 14 1
14 13 1
14 14 1
15 6 1
15 7 1
15 8 1
15 13 1
16 6 1
16 8 1
16 9 1
16 13 1
17 9 1
17 10 1
17 12 1
17 13 1
18 10 1
18 11 1
18 12 1
